6 6 6 6 6 6 6 6 5 5 5 5 6 6 6 6 6 6 6 6
6 6 6 6 6 6 6 6 5 5 5 5 6 6 6 6 6 6 6 6
6 6 5 5 5 6 6 6 5 5 5 5 6 6 6 5 5 5 6 6
6 6 5 7 5 6 6 6 5 6 6 5 6 6 6 5 7 5 6 6
6 6 5 5 5 6 6 6 5 6 6 5 6 6 6 5 5 5 6 6
6 6 6 6 5 6 6 6 5 6 6 5 6 6 6 5 6 6 6 6
6 6 6 6 5 5 5 5 5 5 5 5 5 5 5 5 6 6 6 6
6 6 6 6 5 6 6 6 5 5 5 5 6 6 6 5 6 6 6 6
6 6 5 5 5 6 6 6 5 6 6 5 6 6 6 5 5 5 6 6
6 6 5 7 5 6 6 6 5 6 6 5 6 6 6 5 7 5 6 6
6 6 5 5 5 6 6 6 5 6 6 5 6 6 6 5 5 5 6 6
6 6 6 6 5 6 6 6 5 6 6 5 6 6 6 5 6 6 6 6
6 6 6 6 5 5 5 5 5 8 8 5 5 5 5 5 6 6 6 6
6 6 6 6 6 6 6 6 5 5 5 5 6 6 6 6 6 6 6 6
6 6 6 6 6 6 6 6 5 5 5 5 6 6 6 6 6 6 6 6